Rank	Title	WorldwideLifetimeGross	Domesti LifetimeGross	Domestic%	ForeignLifetimeGross	Foreign%	Year
1	Avengers: Endgame	2797800564	858373000	0.307	1939427564	0.693	2019
2	Avatar	2790439000	760507625	0.272	2029931375	0.728	2009
3	Titanic	2194439542	659363944	0.3	1535075598	0.7	1997
4	Star Wars: Episode VII - The Force Awakens	2068223624	936662225	0.453	1131561399	0.547	2015
5	Avengers: Infinity War	2048359754	678815482	0.331	1369544272	0.669	2018
6	Jurassic World	1670400637	652270625	0.39	1018130012	0.61	2015
7	The Lion King	1656943394	543638043	0.328	1113305351	0.672	2019
8	The Avengers	1518812988	623357910	0.41	895455078	0.59	2012
9	Furious 7	1515047671	353007020	0.233	1162040651	0.767	2015
10	Frozen II	1450026933	477373578	0.329	972653355	0.671	2019
11	Avengers: Age of Ultron	1402805868	459005868	0.327	943800000	0.673	2015
12	Black Panther	1346913161	700059566	0.52	646853595	0.48	2018
13	Harry Potter and the Deathly Hallows: Part 2	1341932398	381409310	0.284	960523088	0.716	2011
14	Star Wars: Episode VIII - The Last Jedi	1332539889	620181382	0.465	712358507	0.535	2017
15	Jurassic World: Fallen Kingdom	1308467944	417719760	0.319	890748184	0.681	2018
16	Frozen	1280802282	400738009	0.313	880064273	0.687	2013
17	Beauty and the Beast	1263521126	504014165	0.399	759506961	0.601	2017
18	Incredibles 2	1242805359	608581744	0.49	634223615	0.51	2018
19	The Fate of the Furious	1236005118	226008385	0.183	1009996733	0.817	2017
20	Iron Man 3	1214811252	409013994	0.337	805797258	0.663	2013
21	Minions	1159398397	336045770	0.29	823352627	0.71	2015
22	Captain America: Civil War	1153296293	408084349	0.354	745211944	0.646	2016
23	Aquaman	1148461807	335061807	0.292	813400000	0.708	2018
24	The Lord of the Rings: The Return of the King	1142219401	377845905	0.331	764373496	0.669	2003
25	Spider-Man: Far from Home	1131927996	390532085	0.345	741395911	0.655	2019
26	Captain Marvel	1128274794	426829839	0.378	701444955	0.622	2019
27	Transformers: Dark of the Moon	1123794079	352390543	0.314	771403536	0.686	2011
28	Skyfall	1108561013	304360277	0.275	804200736	0.725	2012
29	Transformers: Age of Extinction	1104054072	245439076	0.222	858614996	0.778	2014
30	The Dark Knight Rises	1081041287	448139099	0.414	632902188	0.586	2012
31	Joker	1074251311	335451311	0.312	738800000	0.688	2019
32	Star Wars: Episode IX - The Rise of Skywalker	1074144248	515202542	0.48	558941706	0.52	2019
33	Toy Story 4	1073394593	434038008	0.404	639356585	0.596	2019
34	Toy Story 3	1066969703	415004880	0.389	651964823	0.611	2010
35	Pirates of the Caribbean: Dead Man's Chest	1066179725	423315812	0.397	642863913	0.603	2006
36	Rogue One: A Star Wars Story	1056057273	532177324	0.504	523879949	0.496	2016
37	Aladdin	1050693953	355559216	0.338	695134737	0.662	2019
38	Pirates of the Caribbean: On Stranger Tides	1045713802	241071802	0.23	804642000	0.77	2011
39	Despicable Me 3	1034799409	264624300	0.256	770175109	0.744	2017
40	Jurassic Park	1032020521	402828120	0.39	629192401	0.61	1993
41	Finding Dory	1028570889	486295561	0.473	542275328	0.527	2016
42	Star Wars: Episode I - The Phantom Menace	1027082707	474544677	0.462	552538030	0.538	1999
43	Alice in Wonderland	1025467110	334191110	0.326	691276000	0.674	2010
44	Zootopia	1023784195	341268248	0.333	682515947	0.667	2016
45	The Hobbit: An Unexpected Journey	1017003568	303003568	0.298	714000000	0.702	2012
46	The Dark Knight	1004934033	535234033	0.533	469700000	0.467	2008
47	Harry Potter and the Sorcerer's Stone	978087613	318087620	0.325	659999993	0.675	2001
48	Harry Potter and the Deathly Hallows: Part 1	976920103	296347721	0.303	680572382	0.697	2010
49	Despicable Me 2	970766005	368065385	0.379	602700620	0.621	2013
50	The Lion King	968511805	422783777	0.436	545728028	0.564	1994
51	The Jungle Book	966550600	364001123	0.377	602549477	0.623	2016
52	Jumanji: Welcome to the Jungle	962102237	404540171	0.42	557562066	0.58	2017
53	Pirates of the Caribbean: At World's End	960996492	309420425	0.322	651576067	0.678	2007
54	The Hobbit: The Desolation of Smaug	958366855	258366855	0.27	700000000	0.73	2013
55	The Hobbit: The Battle of the Five Armies	956019788	255119788	0.267	700900000	0.733	2014
56	The Lord of the Rings: The Two Towers	951208089	342551365	0.36	608656724	0.64	2002
57	Harry Potter and the Order of the Phoenix	942044510	292353413	0.31	649691097	0.69	2007
58	Finding Nemo	940343261	380843261	0.405	559500000	0.595	2003
59	Harry Potter and the Half-Blood Prince	934326396	302305431	0.324	632020965	0.676	2009
60	Shrek 2	928760770	441226247	0.475	487534523	0.525	2004
61	Bohemian Rhapsody	903655259	216428042	0.24	687227217	0.76	2018
62	Harry Potter and the Goblet of Fire	896346229	290417905	0.324	605928324	0.676	2005
63	Spider-Man 3	894983373	336530303	0.376	558453070	0.624	2007
64	The Lord of the Rings: The Fellowship of the Ring	887832826	315544750	0.355	572288076	0.645	2001
65	Ice Age: Dawn of the Dinosaurs	886686817	196573705	0.222	690113112	0.778	2009
66	Spectre	880674609	200074609	0.227	680600000	0.773	2015
67	Spider-Man: Homecoming	880166924	334201140	0.38	545965784	0.62	2017
68	Harry Potter and the Chamber of Secrets	879465594	262450136	0.298	617015458	0.702	2002
69	Ice Age: Continental Drift	877244782	161321843	0.184	715922939	0.816	2012
70	The Secret Life of Pets	875457937	368384330	0.421	507073607	0.579	2016
71	Batman v Superman: Dawn of Justice	873634919	330360194	0.378	543274725	0.622	2016
72	Wolf Warrior 2	870325439	2721100	0.003	867604339	0.997	2017
73	Star Wars: Episode III - Revenge of the Sith	868390560	380270577	0.438	488119983	0.562	2005
74	The Hunger Games: Catching Fire	865011746	424668047	0.491	440343699	0.509	2013
75	Guardians of the Galaxy Vol. 2	863756051	389813101	0.451	473942950	0.549	2017
76	Inside Out	857611174	356461711	0.416	501149463	0.584	2015
77	Venom	856085151	213515506	0.249	642569645	0.751	2018
78	Thor: Ragnarok	853977126	315058289	0.369	538918837	0.631	2017
79	Transformers: Revenge of the Fallen	836303693	402111870	0.481	434191823	0.519	2009
80	Inception	829895144	292576195	0.352	537318949	0.648	2010
81	The Twilight Saga: Breaking Dawn - Part 2	829746820	292324737	0.352	537422083	0.648	2012
82	Spider-Man	825025036	407022860	0.493	418002176	0.507	2002
83	Wonder Woman	821847012	412563408	0.502	409283604	0.498	2017
84	Independence Day	817400891	306169268	0.375	511231623	0.625	1996
85	Fantastic Beasts and Where to Find Them	814037575	234037575	0.288	580000000	0.712	2016
86	Shrek the Third	813367380	322719944	0.397	490647436	0.603	2007
87	Coco	807082196	209726015	0.26	597356181	0.74	2017
88	Jumanji: The Next Level	796575993	316831246	0.398	479744747	0.602	2019
89	Harry Potter and the Prisoner of Azkaban	796093802	249975996	0.314	546117806	0.686	2004
90	Pirates of the Caribbean: Dead Men Tell No Tales	794861794	172558876	0.217	622302918	0.783	2017
91	E.T. the Extra-Terrestrial	793482178	435110554	0.548	358371624	0.452	1982
92	2012	791217826	166112167	0.21	625105659	0.79	2009
93	Mission: Impossible - Fallout	791115104	220159104	0.278	570956000	0.722	2018
94	Indiana Jones and the Kingdom of the Crystal Skull	790653942	317101119	0.401	473552823	0.599	2008
95	Spider-Man 2	788976453	373585825	0.474	415390628	0.526	2004
96	Fast & Furious 6	788679850	238679850	0.303	550000000	0.697	2013
97	Deadpool 2	785794179	324591735	0.413	461202444	0.587	2018
98	Deadpool	782612155	363070709	0.464	419541446	0.536	2016
99	Star Wars: Episode IV - A New Hope	775512064	460998507	0.594	314513557	0.406	1977
100	Guardians of the Galaxy	772776600	333176600	0.431	439600000	0.569	2014
101	The Da Vinci Code	760006945	217536138	0.286	542470807	0.714	2006
102	Fast & Furious Presents: Hobbs & Shaw	759056935	173956935	0.229	585100000	0.771	2019
103	Maleficent	758410378	241410378	0.318	517000000	0.682	2014
104	The Amazing Spider-Man	757930663	262030663	0.346	495900000	0.654	2012
105	The Hunger Games: Mockingjay - Part 1	755356711	337135885	0.446	418220826	0.554	2014
106	Shrek Forever After	752600867	238736787	0.317	513864080	0.683	2010
107	Madagascar 3: Europe's Most Wanted	746921274	216391482	0.29	530529792	0.71	2012
108	Suicide Squad	746846894	325100054	0.435	421746840	0.565	2016
109	X-Men: Days of Future Past	746045700	233921534	0.314	512124166	0.686	2014
110	The Chronicles of Narnia: The Lion, the Witch and the Wardrobe	745013115	291710957	0.392	453302158	0.608	2005
111	Monsters University	743559607	268492764	0.361	475066843	0.639	2013
112	The Matrix Reloaded	741846459	281576461	0.38	460269998	0.62	2003
113	Up	735099082	293004164	0.399	442094918	0.601	2009
114	Ne Zha	726063471	3695533	0.005	722367938	0.995	2019
115	Gravity	723192705	274092705	0.379	449100000	0.621	2013
116	Captain America: The Winter Soldier	714421503	259766572	0.364	454654931	0.636	2014
117	The Twilight Saga: Breaking Dawn - Part 1	712205856	281287133	0.395	430918723	0.605	2011
118	The Twilight Saga: New Moon	711020081	297816253	0.419	413203828	0.581	2009
119	Dawn of the Planet of the Apes	710644566	208545589	0.294	502098977	0.706	2014
120	Transformers	709709780	319246193	0.45	390463587	0.55	2007
121	The Amazing Spider-Man 2	708982323	202853933	0.286	506128390	0.714	2014
122	It	701796444	328828874	0.469	372967570	0.531	2017
123	The Wandering Earth	699760773	5875487	0.008	693885286	0.992	2019
124	The Twilight Saga: Eclipse	698491347	300531751	0.43	397959596	0.57	2010
125	Mission: Impossible - Ghost Protocol	694713380	209397903	0.301	485315477	0.699	2011
126	The Hunger Games	694394724	408010692	0.588	286384032	0.412	2012
127	Moana	690845539	248757044	0.36	442088495	0.64	2016
128	Mission: Impossible - Rogue Nation	682714267	195042377	0.286	487671890	0.714	2015
129	Forrest Gump	678222284	330455270	0.487	347767014	0.513	1994
130	Doctor Strange	677718395	232641920	0.343	445076475	0.657	2016
131	Interstellar	677471339	188020017	0.278	489451322	0.722	2014
132	The Sixth Sense	672806292	293506292	0.436	379300000	0.564	1999
133	Man of Steel	668045518	291045518	0.436	377000000	0.564	2013
134	Ice Age: The Meltdown	667094506	195330621	0.293	471763885	0.707	2006
135	Kung Fu Panda 2	665692281	165249063	0.248	500443218	0.752	2011
136	The Hunger Games: Mockingjay - Part 2	658344137	281723902	0.428	376620235	0.572	2015
137	Justice League	657924295	229024295	0.348	428900000	0.652	2017
138	Big Hero 6	657827828	222527828	0.338	435300000	0.662	2014
139	Fantastic Beasts: The Crimes of Grindelwald	654855901	159555901	0.244	495300000	0.756	2018
140	Pirates of the Caribbean: The Curse of the Black Pearl	654264015	305413918	0.467	348850097	0.533	2003
141	Star Wars: Episode II - Attack of the Clones	653779970	310676740	0.475	343103230	0.525	2002
142	Thor: The Dark World	644783140	206362140	0.32	438421000	0.68	2013
143	Sing	634151679	270395425	0.426	363756254	0.574	2016
144	Monsters, Inc.	632316649	289916256	0.458	342400393	0.542	2001
145	Kung Fu Panda	631746197	215434591	0.341	416311606	0.659	2008
146	The Incredibles	631606713	261441092	0.414	370165621	0.586	2004
147	The Martian	630161890	228433663	0.362	401728227	0.638	2015
148	Hancock	629443428	227946274	0.362	401497154	0.638	2008
149	Fast Five	626137675	209837675	0.335	416300000	0.665	2011
150	Men in Black 3	624026776	179020854	0.287	445005922	0.713	2012
151	Iron Man 2	623933331	312433331	0.501	311500000	0.499	2010
152	Ratatouille	623726085	206445654	0.331	417280431	0.669	2007
153	Ant-Man and the Wasp	622674139	216648740	0.348	406025399	0.652	2018
154	How to Train Your Dragon 2	621537519	177002924	0.285	444534595	0.715	2014
155	Logan	619021436	226277068	0.366	392744368	0.634	2017
156	The Lost World: Jurassic Park	618638999	229086679	0.37	389552320	0.63	1997
157	Casino Royale	616501619	167445960	0.272	449055659	0.728	2006
158	The Passion of the Christ	612054428	370782930	0.606	241271498	0.394	2004
159	Mamma Mia!	609896805	144169664	0.236	465727141	0.764	2008
160	Life of Pi	609016565	124987023	0.205	484029542	0.795	2012
161	Transformers: The Last Knight	605425157	130168683	0.215	475256474	0.785	2017
162	Madagascar: Escape 2 Africa	603900354	180010950	0.298	423889404	0.702	2008
163	War of the Worlds	603873119	234280354	0.388	369592765	0.612	2005
164	Tangled	592461732	200821936	0.339	391639796	0.661	2010
165	Quantum of Solace	589580482	168368427	0.286	421212055	0.714	2008
166	Men in Black	589390539	250690539	0.425	338700000	0.575	1997
167	The Croods	587204668	187168425	0.319	400036243	0.681	2013
168	The Hangover Part II	586764305	254464305	0.434	332300000	0.566	2011
169	I Am Legend	585410052	256393010	0.438	329017042	0.562	2007
170	Iron Man	585366247	318604126	0.544	266762121	0.456	2008
171	Ready Player One	582890172	137690172	0.236	445200000	0.764	2018
172	Operation Red Sea	579330426	1543547	0.003	577786879	0.997	2018
173	Night at the Museum	574480841	250863268	0.437	323617573	0.563	2006
174	Fifty Shades of Grey	569651467	166167230	0.292	403484237	0.708	2015
175	Kong: Skull Island	566652812	168052812	0.297	398600000	0.703	2017
176	The Smurfs	563749323	142614158	0.253	421135165	0.747	2011
177	King Kong	562363449	218080025	0.388	344283424	0.612	2005
178	Cars 2	559852396	191452396	0.342	368400000	0.658	2011
179	Puss in Boots	554987477	149260504	0.269	405726973	0.731	2011
180	The Mermaid	553810228	3232685	0.006	550577543	0.994	2016
181	Armageddon	553709788	201578182	0.364	352131606	0.636	1998
182	The Day After Tomorrow	552639571	186740799	0.338	365898772	0.662	2004
183	Ted	549368315	218815487	0.398	330552828	0.602	2012
184	Star Wars: Episode V - The Empire Strikes Back	547897454	290271960	0.53	257625494	0.47	1980
185	American Sniper	547426372	350126372	0.64	197300000	0.36	2014
186	Mission: Impossible II	546388108	215409889	0.394	330978219	0.606	2000
187	Detective Chinatown 2	544185156	1983984	0.004	542201172	0.996	2018
188	X-Men: Apocalypse	543934105	155442489	0.286	388491616	0.714	2016
189	Sherlock Holmes: A Game of Shadows	543848418	186848418	0.344	357000000	0.656	2011
190	Despicable Me	543113985	251513985	0.463	291600000	0.537	2010
191	Cinderella	542351353	201151353	0.371	341200000	0.629	2015
192	Madagascar	542063846	193595521	0.357	348468325	0.643	2005
193	World War Z	540007876	202359711	0.375	337648165	0.625	2013
194	Brave	538983207	237283207	0.44	301700000	0.56	2012
195	The Simpsons Movie	536414270	183135014	0.341	353279256	0.659	2007
196	The Revenant	532950503	183637894	0.345	349312609	0.655	2015
197	The Meg	530243742	145443742	0.274	384800000	0.726	2018
198	Ralph Breaks the Internet	529323962	201091711	0.38	328232251	0.62	2018
199	Hotel Transylvania 3: Summer Vacation	528583774	167510016	0.317	361073758	0.683	2018
200	The Boss Baby	527965936	175003033	0.332	352962903	0.668	2017
201	Dunkirk	526940665	189740665	0.36	337200000	0.64	2017
202	Godzilla	524976069	200676069	0.382	324300000	0.618	2014
203	Sherlock Holmes	524028679	209028679	0.399	315000000	0.601	2009
204	Meet the Fockers	522657936	279261160	0.534	243396776	0.466	2004
205	How to Train Your Dragon: The Hidden World	521799505	160799505	0.308	361000000	0.692	2019
206	WALL·E	521311860	223808164	0.429	297503696	0.571	2008
207	Kung Fu Panda 3	521170825	143528619	0.275	377642206	0.725	2016
208	Terminator 2: Judgment Day	520884847	205881154	0.395	315003693	0.605	1991
209	Ant-Man	519311965	180202163	0.347	339109802	0.653	2015
210	The Grinch	511595957	270620950	0.529	240975007	0.471	2018
211	Ghost	505809505	217631306	0.43	288178199	0.57	1990
212	Aladdin	504050219	217350219	0.431	286700000	0.569	1992
213	Rio 2	498781117	131538435	0.264	367242682	0.736	2014
214	Troy	497409852	133378256	0.268	364031596	0.732	2004
215	Toy Story 2	497374776	245852179	0.494	251522597	0.506	1999
216	How to Train Your Dragon	494878759	217581231	0.44	277297528	0.56	2010
217	Twister	494471524	241721524	0.489	252750000	0.511	1996
218	Oz the Great and Powerful	493311825	234911825	0.476	258400000	0.524	2013
219	Clash of the Titans	493214993	163214888	0.331	330000105	0.669	2010
220	Maleficent: Mistress of Evil	491730089	113929605	0.232	377800484	0.768	2019
221	War for the Planet of the Apes	490719763	146880162	0.299	343839601	0.701	2017
222	Mr. & Mrs. Smith	487287646	186336279	0.382	300951367	0.618	2005
223	Angels & Demons	485930816	133375846	0.274	352554970	0.726	2009
224	Teenage Mutant Ninja Turtles	485004754	191204754	0.394	293800000	0.606	2014
225	Bruce Almighty	484592874	242829261	0.501	241763613	0.499	2003
226	Shrek	484409218	267665011	0.553	216744207	0.447	2001
227	Rio	483866518	143619809	0.297	340246709	0.703	2011
228	Saving Private Ryan	482349603	217049603	0.45	265300000	0.55	1998
229	Rise of the Planet of the Apes	481800873	176760185	0.367	305040688	0.633	2011
230	Home Alone	477063114	285761243	0.599	191301871	0.401	1990
231	Star Wars: Episode VI - Return of the Jedi	475347111	309306177	0.651	166040934	0.349	1983
232	Charlie and the Chocolate Factory	474968763	206459076	0.435	268509687	0.565	2005
233	Hotel Transylvania 2	474800000	169700110	0.357	305099890	0.643	2015
234	Indiana Jones and the Last Crusade	474310887	197171806	0.416	277139081	0.584	1989
235	San Andreas	473990832	155190832	0.327	318800000	0.673	2015
236	It Chapter Two	473093228	211593228	0.447	261500000	0.553	2019
237	Wreck-It Ralph	471222889	189422889	0.402	281800000	0.598	2012
238	Jaws	471203004	260000000	0.552	211203004	0.448	1975
239	The Hangover	469310836	277322503	0.591	191988333	0.409	2009
240	The Lego Movie	468060692	257760692	0.551	210300000	0.449	2014
241	Bumblebee	467989645	127195589	0.272	340794056	0.728	2018
242	Star Trek Into Darkness	467365246	228778661	0.49	238586585	0.51	2013
243	The Matrix	465343787	171479930	0.368	293863857	0.632	1999
244	Pretty Woman	463406268	178406268	0.385	285000000	0.615	1990
245	Cars	461983149	244082982	0.528	217900167	0.472	2006
246	Gladiator	460583960	187705427	0.408	272878533	0.592	2000
247	X-Men: The Last Stand	460435291	234362462	0.509	226072829	0.491	2006
248	National Treasure: Book of Secrets	459242249	219964115	0.479	239278134	0.521	2007
249	Lucy	458863600	126663600	0.276	332200000	0.724	2014
250	Mission: Impossible	457731198	180981856	0.395	276749342	0.605	1996
251	300	456068181	210614939	0.462	245453242	0.538	2007
252	The Last Samurai	454627263	111127263	0.244	343500000	0.756	2003
253	Dying to Survive	451183391	6752		451176639	1	2018
254	Ocean's Eleven	450717150	183417150	0.407	267300000	0.593	2001
255	My People, My Country	450064993	2356683	0.005	447708310	0.995	2019
256	Thor	449326618	181030624	0.403	268295994	0.597	2011
257	Pearl Harbor	449220945	198542554	0.442	250678391	0.558	2001
258	Tarzan	448191819	171091819	0.382	277100000	0.618	1999
259	La La Land	446486224	151101803	0.338	295384421	0.662	2016
260	Men in Black II	445135288	193735288	0.435	251400000	0.565	2002
261	The Bourne Ultimatum	444100035	227471070	0.512	216628965	0.488	2007
262	The Mummy Returns	443280904	202019785	0.456	241261119	0.544	2001
263	Alvin and the Chipmunks: The Squeakquel	443140005	219614612	0.496	223525393	0.504	2009
264	Les Misérables	441809770	148809770	0.337	293000000	0.663	2012
265	The Exorcist	441306145	232906145	0.528	208400000	0.472	1973
266	Mrs. Doubtfire	441286195	219195243	0.497	222090952	0.503	1993
267	Terminator Genisys	440603537	89760956	0.204	350842581	0.796	2015
268	Beauty and the Beast	440118382	218967620	0.498	221150762	0.502	1991
269	Warcraft	439048914	47365290	0.108	391683624	0.892	2016
270	A Star Is Born	436188866	215288866	0.494	220900000	0.506	2018
271	The Greatest Showman	434993183	174340174	0.401	260653009	0.599	2017
272	Terminator 3: Rise of the Machines	433371112	150371112	0.347	283000000	0.653	2003
273	Pokémon Detective Pikachu	433005346	144105346	0.333	288900000	0.667	2019
274	Die Another Day	431971116	160942139	0.373	271028977	0.627	2002
275	The Secret Life of Pets 2	430051293	158874395	0.369	271176898	0.631	2019
276	Cast Away	429632142	233632142	0.544	196000000	0.456	2000
277	Rampage	428028233	101028233	0.236	327000000	0.764	2018
278	The King's Speech	427374317	138797449	0.325	288576868	0.675	2010
279	The Matrix Revolutions	427344031	139313948	0.326	288030083	0.674	2003
280	The Intouchables	426588510	10198820	0.024	416389690	0.976	2011
281	Django Unchained	425368238	162805434	0.383	262562804	0.617	2012
282	Dances with Wolves	424208848	184208848	0.434	240000000	0.566	1990
283	The Chronicles of Narnia: Prince Caspian	419665568	141621490	0.338	278044078	0.662	2008
284	Bad Boys for Life	419074646	204417855	0.488	214656791	0.512	2020
285	Sex and the City	418765321	152647258	0.364	266118063	0.636	2008
286	The Captain	416953262	706572	0.002	416246690	0.998	2019
287	The Mummy	415933406	155385488	0.374	260547918	0.626	1999
288	The Chronicles of Narnia: The Voyage of the Dawn Treader	415686217	104386950	0.251	311299267	0.749	2010
289	Jason Bourne	415484914	162434410	0.391	253050504	0.609	2016
290	The Wolverine	414828246	132556852	0.32	282271394	0.68	2013
291	Kingsman: The Secret Service	414351546	128261724	0.31	286089822	0.69	2015
292	Night at the Museum: Battle of the Smithsonian	413106170	177243721	0.429	235862449	0.571	2009
293	Batman	411556825	251348343	0.611	160208482	0.389	1989
294	The Bodyguard	411006740	122006740	0.297	289000000	0.703	1992
295	Pacific Rim	411002906	101802906	0.248	309200000	0.752	2013
296	Kingsman: The Golden Circle	410902662	100234838	0.244	310667824	0.756	2017
297	The Mummy	409231607	80227895	0.196	329003712	0.804	2017
298	Ice Age: Collision Course	408579038	64063008	0.157	344516030	0.843	2016
299	Twilight	408424673	193962473	0.475	214462200	0.525	2008
300	Signs	408247917	227966634	0.558	180281283	0.442	2002
301	X2: X-Men United	407711549	214949694	0.527	192761855	0.473	2003
302	Alita: Battle Angel	404852543	85710210	0.212	319142333	0.788	2019
303	Toy Story	404265438	222498679	0.55	181766759	0.45	1995
304	The Mummy: Tomb of the Dragon Emperor	403449830	102491776	0.254	300958054	0.746	2008
305	Prometheus	403354469	126477084	0.314	276877385	0.686	2012
306	Gone with the Wind	402352579	200852579	0.499	201500000	0.501	1939
307	TRON: Legacy	400062763	172062763	0.43	228000000	0.57	2010
308	Mission: Impossible III	398479497	134029801	0.336	264449696	0.664	2005
309	Grease	396961563	189969103	0.479	206992460	0.521	1978
310	Snow White and the Huntsman	396592829	155332381	0.392	241260448	0.608	2012
311	Mamma Mia! Here We Go Again	395044706	120634935	0.305	274409771	0.695	2018
312	Solo: A Star Wars Story	392924807	213767512	0.544	179157295	0.456	2018
313	The Wolf of Wall Street	392000694	116900694	0.298	275100000	0.702	2013
314	Superman Returns	391081192	200081192	0.512	191000000	0.488	2006
315	Robin Hood: Prince of Thieves	390493908	165493908	0.424	225000000	0.576	1991
316	Raiders of the Lost Ark	390133212	248159971	0.636	141973241	0.364	1981
317	Independence Day: Resurgence	389681935	103144286	0.265	286537649	0.735	2016
318	Back to the Future	388355305	211159762	0.544	177195543	0.456	1985
319	Live Free or Die Hard	388156011	134529403	0.347	253626608	0.653	2007
320	Monster Hunt	387053506	32766		387020740	1	2015
321	Godzilla: King of the Monsters	386600138	110500138	0.286	276100000	0.714	2019
322	Home	386041607	177397510	0.46	208644097	0.54	2015
323	Star Trek	385680446	257730019	0.668	127950427	0.332	2009
324	Happy Feet	384335608	198000317	0.515	186335291	0.485	2006
325	Cars 3	383930656	152901115	0.398	231029541	0.602	2017
326	Ice Age	383257136	176387405	0.46	206869731	0.54	2002
327	Fifty Shades Darker	381545846	114581250	0.3	266964596	0.7	2017
328	Monsters vs. Aliens	381509870	198351526	0.52	183158344	0.48	2009
329	Godzilla	379014294	136314294	0.36	242700000	0.64	1998
330	True Lies	378882411	146282411	0.386	232600000	0.614	1994
331	Slumdog Millionaire	378021385	141319928	0.374	236701457	0.626	2008
332	Taken 2	376141306	139854287	0.372	236287019	0.628	2012
333	G.I. Joe: Retaliation	375740705	122523060	0.326	253217645	0.674	2013
334	Spider-Man: Into the Spider-Verse	375540831	190241310	0.507	185299521	0.493	2018
335	Mad Max: Fury Road	375209362	154058340	0.411	221151022	0.589	2015
336	Shark Tale	374583879	160861908	0.429	213721971	0.571	2004
337	Once Upon a Time... in Hollywood	374343626	142502728	0.381	231840898	0.619	2019
338	What Women Want	374111707	182811707	0.489	191300000	0.511	2000
339	The Adventures of Tintin	373993951	77591831	0.208	296402120	0.792	2011
340	Penguins of Madagascar	373515621	83850911	0.224	289664710	0.776	2014
341	Batman Begins	373413297	206852432	0.554	166560865	0.446	2005
342	X-Men Origins: Wolverine	373062864	179883157	0.482	193179707	0.518	2009
343	The Golden Compass	372234864	70107728	0.188	302127136	0.812	2007
344	Fifty Shades Freed	371985018	100407760	0.27	271577258	0.73	2018
345	Hitch	371594210	179495555	0.483	192098655	0.517	2005
346	Terminator Salvation	371353001	125322469	0.338	246030532	0.662	2009
347	Captain America: The First Avenger	370569774	176654505	0.477	193915269	0.523	2011
348	Edge of Tomorrow	370541256	100206256	0.27	270335000	0.73	2014
349	There's Something About Mary	369884651	176484651	0.477	193400000	0.523	1998
350	Gone Girl	369330363	167767189	0.454	201563174	0.546	2014
351	The Fugitive	368875760	183875760	0.498	185000000	0.502	1993
352	Jurassic Park III	368780809	181171875	0.491	187608934	0.509	2001
353	My Big Fat Greek Wedding	368744044	241438208	0.655	127305836	0.345	2002
354	1917	368027644	159227644	0.433	208800000	0.567	2019
355	Die Hard with a Vengeance	366236538	100012499	0.273	266224039	0.727	1995
356	Shazam!	365971656	140371656	0.384	225600000	0.616	2019
357	The Nun	365550119	117450119	0.321	248100000	0.679	2018
358	Alvin and the Chipmunks	365352546	217326974	0.595	148025572	0.405	2007
359	Home Alone 2: Lost in New York	365154932	173585516	0.475	191569416	0.525	1992
360	Notting Hill	363944522	116089678	0.319	247854844	0.681	1999
361	A Bug's Life	363258859	162798565	0.448	200460294	0.552	1998
362	Night at the Museum: Secret of the Tomb	363204635	113746621	0.313	249458014	0.687	2014
363	Ocean's Twelve	362744280	125544280	0.346	237200000	0.654	2004
364	Planet of the Apes	362211740	180011740	0.497	182200000	0.503	2001
365	The Hangover Part III	362000072	112200072	0.31	249800000	0.69	2013
366	The World Is Not Enough	361832400	126943684	0.351	234888716	0.649	1999
367	Monster Hunt 2	361682618	706153	0.002	360976465	0.998	2018
368	Fast & Furious	360364265	155064265	0.43	205300000	0.57	2009
369	Noah	359200044	101200044	0.282	258000000	0.718	2014
370	The Karate Kid	359126022	176591618	0.492	182534404	0.508	2010
371	Your Name.	358922706	5017246	0.014	353905460	0.986	2016
372	Hotel Transylvania	358375603	148313048	0.414	210062555	0.586	2011
373	Minority Report	358372926	132072926	0.368	226300000	0.632	2002
374	Top Gun	356830601	179800601	0.504	177030000	0.496	1986
375	The Legend of Tarzan	356700357	126643061	0.355	230057296	0.645	2016
376	American Beauty	356296601	130096601	0.365	226200000	0.635	1999
377	Apollo 13	355237933	173837933	0.489	181400000	0.511	1995
378	Rain Man	354825435	172825435	0.487	182000000	0.513	1988
379	The Great Gatsby	353641895	144840419	0.41	208801476	0.59	2013
380	Dumbo	353284621	114766307	0.325	238518314	0.675	2019
381	I, Robot	353133898	144801023	0.41	208332875	0.59	2004
382	Basic Instinct	352927224	117727224	0.334	235200000	0.666	1992
383	Murder on the Orient Express	352789811	102826543	0.292	249963268	0.708	2017
384	X-Men: First Class	352616690	146408305	0.415	206208385	0.585	2011
385	The Angry Birds Movie	352333929	107509366	0.305	244824563	0.695	2016
386	GoldenEye	352194034	106429941	0.302	245764093	0.698	1995
387	Catch Me If You Can	352114312	164615351	0.468	187498961	0.532	2002
388	Now You See Me	351723989	117723989	0.335	234000000	0.665	2013
389	Hannibal	351692268	165092268	0.469	186600000	0.531	2001
390	The Mask	351583407	119938730	0.341	231644677	0.659	1994
391	Peter Rabbit	351266433	115253424	0.328	236013009	0.672	2018
392	Speed	350448145	121248145	0.346	229200000	0.654	1994
393	Dinosaur	349822765	137748063	0.394	212074702	0.606	2000
394	Mary Poppins Returns	349537494	171958438	0.492	177579056	0.508	2018
395	Deep Impact	349464664	140464664	0.402	209000000	0.598	1998
396	The Lorax	348840316	214030500	0.614	134809816	0.386	2012
397	The Maze Runner	348319861	102427862	0.294	245891999	0.706	2014
398	Spirited Away	347742810	13750644	0.04	333992166	0.96	2001
399	The Smurfs 2	347545360	71017784	0.204	276527576	0.796	2013
400	National Treasure	347512318	173008894	0.498	174503424	0.502	2004
401	Rush Hour 2	347325802	226164286	0.651	121161516	0.349	2001
402	Trolls	346864462	153707064	0.443	193157398	0.557	2016
403	xXx: Return of Xander Cage	346118277	44898413	0.13	301219864	0.87	2017
404	Pocahontas	346079773	141579773	0.409	204500000	0.591	1995
405	How the Grinch Stole Christmas	345141403	260044825	0.753	85096578	0.247	2000
406	Star Trek Beyond	343471816	158848340	0.462	184623476	0.538	2016
407	Alvin and the Chipmunks: Chipwrecked	342695435	133110742	0.388	209584693	0.612	2011
408	Wanted	342463063	134508551	0.393	207954512	0.607	2008
409	The Flintstones	341631208	130531208	0.382	211100000	0.618	1994
410	A Quiet Place	340939361	188024361	0.552	152915000	0.448	2018
411	Enchanted	340487652	127807262	0.375	212680390	0.625	2007
412	Over the Hedge	339795890	155019340	0.456	184776550	0.544	2006
413	300: Rise of an Empire	337580051	106580051	0.316	231000000	0.684	2014
414	Batman Forever	336567531	184069126	0.547	152498405	0.453	1995
415	Prince of Persia: The Sands of Time	336365676	90759676	0.27	245606000	0.73	2009
416	Back to the Future Part II	335949377	119000002	0.354	216949375	0.646	1989
417	The Curious Case of Benjamin Button	335802786	127509326	0.38	208293460	0.62	2008
418	Journey 2: The Mysterious Island	335260290	103860290	0.31	231400000	0.69	2012
419	The Rock	335062621	134069511	0.4	200993110	0.6	1996
420	The Great Wall	334933831	45540830	0.136	289393001	0.864	2016
421	Now You See Me 2	334897606	65075540	0.194	269822066	0.806	2016
422	Fantastic Four	333535934	154696080	0.464	178839854	0.536	2005
423	Indiana Jones and the Temple of Doom	333107271	179870271	0.54	153237000	0.46	1984
424	Tomorrow Never Dies	333011068	125304276	0.376	207706792	0.624	1997
425	The Good Dinosaur	332207671	123087120	0.37	209120551	0.63	2015
426	22 Jump Street	331333876	191719337	0.579	139614539	0.421	2014
427	Meet the Parents	330444045	166244045	0.503	164200000	0.497	2000
428	Who Framed Roger Rabbit	329803958	156452370	0.474	173351588	0.526	1988
429	Black Swan	329398046	106954678	0.325	222443368	0.675	2010
430	The Perfect Storm	328718434	182618434	0.556	146100000	0.444	2000
431	Crocodile Dundee	328203506	174803506	0.533	153400000	0.467	1986
432	Green Book	327909440	85080171	0.26	242829269	0.74	2018
433	The Devil Wears Prada	327893740	124740460	0.38	203153280	0.62	2006
434	Se7en	327333559	100125643	0.306	227207916	0.694	1995
435	John Wick: Chapter 3 - Parabellum	326709727	171015687	0.523	155694040	0.477	2019
436	Taken 3	326479141	89256424	0.273	237222717	0.727	2015
437	The Hunchback of Notre Dame	325338851	100138851	0.308	225200000	0.692	1996
438	A Christmas Carol	325286646	137855863	0.424	187430783	0.576	2009
439	The SpongeBob Movie: Sponge Out of Water	325186032	162994032	0.501	162192000	0.499	2015
440	Schindler's List	322287794	96898818	0.301	225388976	0.699	1993
441	Megamind	321885765	148415853	0.461	173469912	0.539	2010
442	Lethal Weapon 3	321731527	144731527	0.45	177000000	0.55	1992
443	The Ugly Truth	321682600	88915214	0.276	232767386	0.724	2009
444	Robin Hood	321669741	105269730	0.327	216400011	0.673	2010
445	Inglourious Basterds	321455689	120540719	0.375	200914970	0.625	2009
446	101 Dalmatians	320689294	136189294	0.425	184500000	0.575	1996
447	The Conjuring 2	320392818	102470008	0.32	217922810	0.68	2016
448	Fatal Attraction	320145693	156645693	0.489	163500000	0.511	1987
449	The Last Airbender	319713881	131772187	0.412	187941694	0.588	2010
450	The Conjuring	319494638	137400141	0.43	182094497	0.57	2013
451	The Proposal	317375031	163958031	0.517	153417000	0.483	2009
452	A Beautiful Mind	316791257	170742341	0.539	146048916	0.461	2001
453	Beverly Hills Cop	316360478	234760478	0.742	81600000	0.258	1984
454	Air Force One	315156409	172956409	0.549	142200000	0.451	1997
455	The Expendables 2	314975955	85028192	0.27	229947763	0.73	2012
456	Chicken Little	314432837	135386665	0.431	179046172	0.569	2005
457	As Good as It Gets	314178011	148478011	0.473	165700000	0.527	1997
458	The Polar Express	313500433	187224490	0.597	126275943	0.403	2004
459	Maze Runner: The Scorch Trials	312296056	81697192	0.262	230598864	0.738	2015
460	Resident Evil: The Final Chapter	312242626	26830068	0.086	285412558	0.914	2016
461	Austin Powers: The Spy Who Shagged Me	312016928	206040086	0.66	105976842	0.34	1999
462	The Lego Batman Movie	311950384	175750384	0.563	136200000	0.437	2017
463	Ocean's Thirteen	311312624	117154724	0.376	194157900	0.624	2007
464	Little Fockers	310650585	148438600	0.478	162211985	0.522	2010
465	Bolt	309979994	114053579	0.368	195926415	0.632	2008
466	Ransom	309492681	136492681	0.441	173000000	0.559	1996
467	Runaway Bride	309460292	152257509	0.492	157202783	0.508	1999
468	Knives Out	309232797	165363234	0.535	143869563	0.465	2019
469	The Blind Side	309208309	255959475	0.828	53248834	0.172	2009
470	The Ex-File 3: The Return of The Exes	307592427	838959	0.003	306753468	0.997	2017
471	The Fault in Our Stars	307166834	124872350	0.406	182294484	0.594	2014
472	The Pursuit of Happyness	307127625	163566459	0.533	143561166	0.467	2006
473	Rise of the Guardians	306941670	103412758	0.337	203528912	0.663	2012
474	Close Encounters of the Third Kind	306898466	135189114	0.44	171709352	0.56	1977
475	Chicago	306776732	170687518	0.556	136089214	0.444	2002
476	Sonic the Hedgehog	306766470	146066470	0.476	160700000	0.524	2020
477	Annabelle: Creation	306515884	102092201	0.333	204423683	0.667	2017
478	Wonder	305937718	132422809	0.433	173514909	0.567	2017
479	Skyscraper	304868961	68420120	0.224	236448841	0.776	2018
480	A Good Day to Die Hard	304654182	67349198	0.221	237304984	0.779	2013
481	Mulan	304320254	120620254	0.396	183700000	0.604	1998
482	Dangal	303723636	12391761	0.041	291331875	0.959	2016
483	Passengers	303144152	100014699	0.33	203129453	0.67	2016
484	Battleship	303025485	65422625	0.216	237602860	0.784	2012
485	Liar Liar	302710615	181410615	0.599	121300000	0.401	1997
486	G.I. Joe: The Rise of Cobra	302469017	150201498	0.497	152267519	0.503	2009
487	Wrath of the Titans	301970083	83670083	0.277	218300000	0.723	2012
488	Fantastic 4: Rise of the Silver Surfer	301913131	131921738	0.437	169991393	0.563	2007
489	Hook	300854823	119654823	0.398	181200000	0.602	1991
490	Rocky IV	300473716	127873716	0.426	172600000	0.574	1985
491	Superman	300451603	134451603	0.448	166000000	0.552	1978
492	Rambo: First Blood Part II	300400432	150415432	0.501	149985000	0.499	1985
493	Resident Evil: Afterlife	300228084	60128566	0.2	240099518	0.8	2010
494	Van Helsing	300157638	120177084	0.4	179980554	0.6	2004
495	Stuart Little	300135367	140035367	0.467	160100000	0.533	1999
496	Beverly Hills Cop II	299965036	153665036	0.512	146300000	0.488	1987
497	Alice Through the Looking Glass	299457024	77041381	0.257	222415643	0.743	2016
498	My Best Friend's Wedding	299288605	127120029	0.425	172168576	0.575	1997
499	Real Steel	299268508	85468508	0.286	213800000	0.714	2011
500	Horton Hears a Who!	298572799	154529439	0.518	144043360	0.482	2008
501	Ocean's Eight	297718711	140218711	0.471	157500000	0.529	2018
502	Insurgent	297002527	130179072	0.438	166823455	0.562	2015
503	Look Who's Talking	296999813	140088813	0.472	156911000	0.528	1989
504	Austin Powers in Goldmember	296938801	213307889	0.718	83630912	0.282	2002
505	Miss Peregrine's Home for Peculiar Children	296482446	87242834	0.294	209239612	0.706	2016
506	X-Men	296339528	157299718	0.531	139039810	0.469	2000
507	Ferdinand	296069199	84410380	0.285	211658819	0.715	2017
508	Ghostbusters	295743767	242582079	0.82	53161688	0.18	1984
509	Shutter Island	294804195	128012934	0.434	166791261	0.566	2010
510	Doctor Dolittle	294456605	144156605	0.49	150300000	0.51	1998
511	Bee Movie	293514336	126631277	0.431	166883059	0.569	2007
512	Salt	293503354	118311368	0.403	175191986	0.597	2010
513	G-Force	292817841	119436770	0.408	173381071	0.592	2009
514	The Departed	291465034	132384315	0.454	159080719	0.546	2006
515	What Lies Beneath	291420351	155464351	0.534	135956000	0.466	2000
516	Pacific Rim: Uprising	290930148	59874525	0.206	231055623	0.794	2018
517	The Bourne Supremacy	290835269	176241941	0.606	114593328	0.394	2004
518	Sex and the City 2	290745055	95347692	0.328	195397363	0.672	2010
519	Shakespeare in Love	289317794	100317794	0.347	189000000	0.653	1998
520	Divergent	288885818	150947895	0.522	137937923	0.478	2014
521	Coming to America	288752301	128152301	0.444	160600000	0.556	1988
522	Wedding Crashers	288467645	209255921	0.725	79211724	0.275	2005
523	Bridesmaids	288383523	169106725	0.586	119276798	0.414	2011
524	Maze Runner: The Death Cure	288175335	58032443	0.201	230142892	0.799	2018
525	Casper	287928194	100328194	0.348	187600000	0.652	1995
526	American Pie 2	287553595	145103595	0.505	142450000	0.495	2001
527	Pitch Perfect 2	287144079	184296230	0.642	102847849	0.358	2015
528	The Green Mile	286801374	136801374	0.477	150000000	0.523	1999
529	Oblivion	286168572	89107235	0.311	197061337	0.689	2013
530	Elysium	286140700	93050117	0.325	193090583	0.675	2013
531	Lethal Weapon 4	285444603	130444603	0.457	155000000	0.543	1998
532	John Carter	284139100	73078100	0.257	211061000	0.743	2012
533	Paddington	282839394	76271832	0.27	206567562	0.73	2014
534	Turbo	282570682	83028128	0.294	199542554	0.706	2013
535	Bridget Jones's Diary	281929795	71543427	0.254	210386368	0.746	2001
536	The Tourist	278780441	67631157	0.243	211149284	0.757	2010
537	Split	278454358	138291365	0.497	140162993	0.503	2017
538	Scary Movie	278019771	157019771	0.565	121000000	0.435	2000
539	xXx	277448382	142109382	0.512	135339000	0.488	2002
540	The Bourne Legacy	276144750	113203870	0.41	162940880	0.59	2012
541	Mr. Peabody & Sherman	275698039	111506430	0.404	164191609	0.596	2014
542	Scooby-Doo	275650703	153294164	0.556	122356539	0.444	2002
543	Lincoln	275293450	182207973	0.662	93085477	0.338	2012
544	Lara Croft: Tomb Raider	274703340	131168070	0.478	143535270	0.522	2001
545	Tomb Raider	274650803	58250803	0.212	216400000	0.788	2018
546	The Expendables	274470394	103068524	0.376	171401870	0.624	2010
547	Cloudy with a Chance of Meatballs 2	274325949	119793567	0.437	154532382	0.563	2013
548	The Little Mermaid	274176364	111543479	0.407	162632885	0.593	1989
549	The Nutty Professor	273961019	128814019	0.47	145147000	0.53	1996
550	Jerry Maguire	273552592	153952592	0.563	119600000	0.437	1996
551	Bad Boys II	273339556	138608444	0.507	134731112	0.493	2003
552	Lilo & Stitch	273144151	145794338	0.534	127349813	0.466	2002
553	The Silence of the Lambs	272753884	130742922	0.479	142010962	0.521	1991
554	Grown Ups	271430189	162001186	0.597	109429003	0.403	2010
555	Neighbors	270665134	150157400	0.555	120507734	0.445	2014
556	The Firm	270248367	158348367	0.586	111900000	0.414	1993
557	We're the Millers	269994119	150394119	0.557	119600000	0.443	2012
558	Gran Torino	269958228	148095302	0.549	121862926	0.451	2008
559	10,000 BC	269784201	94784201	0.351	175000000	0.649	2008
560	American Gangster	269755430	130164645	0.482	139590785	0.518	2007
561	Epic	268426634	107518682	0.401	160907952	0.599	2013
562	Exodus: Gods and Kings	268175631	65014513	0.242	203161118	0.758	2014
563	Bambi	267447150	102247150	0.382	165200000	0.618	1942
564	The Princess and the Frog	267045765	104400899	0.391	162644866	0.609	2009
565	Batman Returns	266903053	162902340	0.61	104000713	0.39	1992
566	Indecent Proposal	266614059	106614059	0.4	160000000	0.6	1993
567	Something's Gotta Give	265328738	124728738	0.47	140600000	0.53	2003
568	Bridget Jones: The Edge of Reason	265126918	40226215	0.152	224900703	0.848	2004
569	The Incredible Hulk	264770996	134806913	0.509	129964083	0.491	2008
570	Waterworld	264218220	88246220	0.334	175972000	0.666	1995
571	The Truman Show	264118201	125618201	0.476	138500000	0.524	1998
572	Charlie's Angels	264105545	125305545	0.474	138800000	0.526	2000
573	The Fifth Element	264029966	63820180	0.242	200209786	0.758	1997
574	Jumanji	262821940	100499940	0.382	162322000	0.618	1995
575	Borat: Cultural Learnings of America for Make Benefit Glorious Nation of Kazakhstan	262552893	128505958	0.489	134046935	0.511	2006
576	Robots	262511490	128200012	0.488	134311478	0.512	2005
577	Knight and Day	261989769	76423035	0.292	185566734	0.708	2008
578	Total Recall	261317921	119412921	0.457	141905000	0.543	1990
579	This Is It	261183588	72091016	0.276	189092572	0.724	2009
580	Terminator: Dark Fate	261119292	62253077	0.238	198866215	0.762	2019
581	The Lone Ranger	260502115	89302115	0.343	171200000	0.657	2013
582	Super 8	260095986	127004179	0.488	133091807	0.512	2011
583	Xun long jue	259368448	1243810	0.005	258124638	0.995	2015
584	Blade Runner 2049	259239658	92054159	0.355	167185499	0.645	2017
585	Charlie's Angels: Full Throttle	259175788	100830111	0.389	158345677	0.611	2003
586	Rush Hour 3	258097122	140125968	0.543	117971154	0.457	2007
587	The Full Monty	257938649	45950122	0.178	211988527	0.822	1997
588	Kung Fu Yoga	257743016	362657	0.001	257380359	0.999	2017
589	Annabelle	257047661	84273813	0.328	172773848	0.672	2014
590	The Village	256697520	114197520	0.445	142500000	0.555	2003
591	Lost in Hong Kong	256283912	1302281	0.005	254981631	0.995	2015
592	Erin Brockovich	256271286	125595205	0.49	130676081	0.51	2000
593	Marley & Me	255743093	143153751	0.56	112589342	0.44	2008
594	Halloween	255485178	159342015	0.624	96143163	0.376	2018
595	Get Out	255413717	176040665	0.689	79373052	0.311	2017
596	Us	255184580	175084580	0.686	80100000	0.314	2019
597	Cliffhanger	255000211	84049211	0.33	170951000	0.67	1993
598	Baahubali 2: The Conclusion	254158390	20186659	0.079	233971731	0.921	2017
599	Parasite	254138371	53369749	0.21	200768622	0.79	2019
600	Babe	254134910	63658910	0.25	190476000	0.75	1995
601	Men in Black: International	253890701	80001807	0.315	173888894	0.685	2019
602	Wild Hogs	253625427	168273550	0.664	85351877	0.336	2007
603	High School Musical 3	252909177	90559416	0.358	162349761	0.642	2008
604	Hercules	252712101	99112101	0.392	153600000	0.608	1997
605	X-Men: Dark Phoenix	252442974	65845974	0.261	186597000	0.739	2019
606	True Grit	252276927	171243005	0.679	81033922	0.321	2010
607	Bean	251212670	45319423	0.18	205893247	0.82	1997
608	American Hustle	251171807	150117807	0.598	101054000	0.402	2013
609	Enemy of the State	250849789	111549836	0.445	139299953	0.555	1998
610	You've Got Mail	250821495	115821495	0.462	135000000	0.538	1998
611	Eragon	250425512	75030163	0.3	175395349	0.7	2006
612	Brother Bear	250397798	85336277	0.341	165061521	0.659	2003
613	The Mask of Zorro	250288523	94095523	0.376	156193000	0.624	1998
614	The Ring	249348933	129128133	0.518	120220800	0.482	2002
615	The Blair Witch Project	248639099	140539099	0.565	108100000	0.435	1999
616	Unbreakable	248118121	95011339	0.383	153106782	0.617	2000
617	Journey to the West: The Demons Strike Back	247585244	880346	0.004	246704898	0.996	2017
618	Dumb and Dumber	247275374	127175374	0.514	120100000	0.486	1994
619	Glass	246999039	111048468	0.45	135950571	0.55	2019
620	Grown Ups 2	246984278	133668525	0.541	113315753	0.459	2013
621	The Peanuts Movie	246233113	130178411	0.529	116054702	0.471	2015
622	Back to the Future Part III	246144250	88277583	0.359	157866667	0.641	1990
623	The Godfather	246120974	134966411	0.548	111154563	0.452	1972
624	Rango	245724603	123477607	0.502	122246996	0.498	2011
625	Four Weddings and a Funeral	245700832	52700832	0.214	193000000	0.786	1994
626	Face/Off	245676146	112276146	0.457	133400000	0.543	1997
627	Teenage Mutant Ninja Turtles: Out of the Shadows	245623848	82051601	0.334	163572247	0.666	2016
628	Dark Shadows	245527149	79727149	0.325	165800000	0.675	2012
629	Hulk	245285165	132177234	0.539	113107931	0.461	2003
630	The Bravest	245179562	290217	0.001	244889345	0.999	2019
631	Love Actually	244931766	59696144	0.244	185235622	0.756	2003
632	Pixels	244874809	78747585	0.322	166127224	0.678	2015
633	Hercules	244819862	72688614	0.297	172131248	0.703	2014
634	Rush Hour	244721064	141186864	0.577	103534200	0.423	1998
635	Journey to the Center of the Earth	244232688	101704370	0.416	142528318	0.584	2008
636	After Earth	243611982	60522097	0.248	183089885	0.752	2013
637	A Few Good Men	243240178	141340178	0.581	101900000	0.419	1992
638	Cloudy with a Chance of Meatballs	243006126	124870275	0.514	118135851	0.486	2009
639	8 Mile	242875078	116750901	0.481	126124177	0.519	2002
640	Daddy's Home	242786137	150357137	0.619	92429000	0.381	2015
641	RoboCop	242688965	58607007	0.242	184081958	0.758	2014
642	Eraser	242295562	101295562	0.418	141000000	0.582	1996
643	Alien: Covenant	240891763	74262031	0.308	166629732	0.692	2017
644	Sully	240797623	125070033	0.519	115727590	0.481	2016
645	Assassin's Creed	240697856	54647948	0.227	186049908	0.773	2016
646	Click	240685326	137355633	0.571	103329693	0.429	2006
647	Die Hard 2	240247433	117540947	0.489	122706486	0.511	1990
648	Resident Evil: Retribution	240159255	42345531	0.176	197813724	0.824	2012
649	Crocodile Dundee II	239606210	109306210	0.456	130300000	0.544	1988
650	Planes	239258712	90288712	0.377	148970000	0.623	2013
651	Crazy Rich Asians	238532921	174532921	0.732	64000000	0.268	2018
652	Batman & Robin	238235915	107353792	0.451	130882123	0.549	1997
653	Gulliver's Travels	237382724	42779261	0.18	194603463	0.82	2010
654	Gone in 60 Seconds	237202299	101648571	0.428	135553728	0.572	2000
655	Saturday Night Fever	237113184	94213184	0.397	142900000	0.603	1977
656	Silver Linings Playbook	236412453	132092958	0.559	104319495	0.441	2012
657	2 Fast 2 Furious	236350661	127154901	0.538	109195760	0.462	2003
658	Howl's Moving Castle	236212992	5576743	0.024	230636249	0.976	2004
659	Hidden Figures	235956898	169607287	0.719	66349611	0.281	2016
660	A.I. Artificial Intelligence	235926552	78616689	0.333	157309863	0.667	2001
661	Dead Poets Society	235860116	95860116	0.406	140000000	0.594	1988
662	Spy	235666219	110825712	0.47	124840507	0.53	2015
663	American Pie	235483004	102561004	0.436	132922000	0.564	1999
664	American Reunion	234989584	57011521	0.243	177978063	0.757	2012
665	Big Daddy	234801895	163479795	0.696	71322100	0.304	1999
666	Alvin and the Chipmunks: The Road Chip	234798636	85886987	0.366	148911649	0.634	2015
667	The Imitation Game	233555708	91125683	0.39	142430025	0.61	2014
668	The Day the Earth Stood Still	233093859	79366978	0.34	153726881	0.66	2008
669	American Wedding	232722935	104565114	0.449	128157821	0.551	2003
670	The Girl with the Dragon Tattoo	232617430	102515793	0.441	130101637	0.559	2011
671	Juno	232372681	143495265	0.618	88877416	0.382	2007
672	Argo	232325503	136025503	0.586	96300000	0.414	2012
673	Mr. Bean's Holiday	232225908	33302167	0.143	198923741	0.857	2007
674	The English Patient	231976425	78676425	0.339	153300000	0.661	1996
675	Sister Act	231605150	139605150	0.603	92000000	0.397	1992
676	Annabelle Comes Home	231252591	74152591	0.321	157100000	0.679	2019
677	Constantine	230884728	75976178	0.329	154908550	0.671	2005
678	Get Smart	230685453	130319208	0.565	100366245	0.435	2008
679	Space Jam	230418342	90418342	0.392	140000000	0.608	1996
680	Life Is Beautiful	230098753	57563264	0.25	172535489	0.75	1998
681	The Heat	229930771	159582188	0.694	70348583	0.306	2013
682	Ghostbusters	229147509	128350574	0.56	100796935	0.44	2016
683	Ghost Rider	228738393	115802596	0.506	112935797	0.494	2007
684	Goodbye Mr. Loser	228122928	1293626	0.006	226829302	0.994	2015
685	Paddington 2	227978523	40891591	0.179	187086932	0.821	2017
686	Sleepless in Seattle	227927165	126808165	0.556	101119000	0.444	1993
687	Lethal Weapon 2	227853986	147253986	0.646	80600000	0.354	1989
688	The Green Hornet	227817248	98780042	0.434	129037206	0.566	2011
689	Out of Africa	227542205	87071205	0.383	140471000	0.617	1985
690	Youth	227091290	1891956	0.008	225199334	0.992	2017
691	Baby Driver	226945087	107825862	0.475	119119225	0.525	2017
692	Immortals	226904017	83504017	0.368	143400000	0.632	2011
693	Taken	226837760	145000989	0.639	81836771	0.361	2008
694	Percy Jackson & the Olympians: The Lightning Thief	226497209	88768303	0.392	137728906	0.608	2010
695	Hansel & Gretel: Witch Hunters	226349749	55703475	0.246	170646274	0.754	2013
696	Good Will Hunting	225933435	138433435	0.613	87500000	0.387	1997
697	Valerian and the City of a Thousand Planets	225874228	41189488	0.182	184684740	0.818	2017
698	Ford v Ferrari	225508210	117624357	0.522	107883853	0.478	2019
699	Better Days	225320294	1921657	0.008	223398637	0.992	2019
700	Jumper	225132113	80172128	0.356	144959985	0.644	2008
701	The Social Network	224920315	96962694	0.431	127957621	0.569	2010
702	Chicken Run	224834564	106834564	0.475	118000000	0.525	2000
703	Con Air	224012234	101117573	0.451	122894661	0.549	1997
704	Interview with the Vampire: The Vampire Chronicles	223664608	105264608	0.471	118400000	0.529	1994
705	Flightplan	223387299	89707299	0.402	133680000	0.598	2005
706	Dolittle	223343452	77047065	0.345	146296387	0.655	2020
707	Yes Man	223241637	97690976	0.438	125550661	0.562	2008
708	Non-Stop	222809600	92168600	0.414	130641000	0.586	2014
709	Honey, I Shrunk the Kids	222724172	130724172	0.587	92000000	0.413	1989
710	Fahrenheit 9/11	222446882	119194771	0.536	103252111	0.464	2004
711	Wild Wild West	222104681	113804681	0.512	108300000	0.488	1999
712	Elf	221671773	174626840	0.788	47044933	0.212	2003
713	Geostorm	221600160	33700160	0.152	187900000	0.848	2017
714	Presumed Innocent	221303188	86303188	0.39	135000000	0.61	1990
715	Collateral	220926695	101005703	0.457	119920992	0.543	2004
716	Scary Movie 3	220673217	110003217	0.498	110670000	0.502	2003
717	Inferno	220021259	34343574	0.156	185677685	0.844	2016
718	Knocked Up	219922417	148768917	0.676	71153500	0.324	2007
719	Green Lantern	219851172	116601172	0.53	103250000	0.47	2011
720	What Happens in Vegas	219375562	80277646	0.366	139097916	0.634	2008
721	It's Complicated	219103655	112735375	0.514	106368280	0.486	2009
722	The Terminal	219100084	77872883	0.355	141227201	0.645	2004
723	Captain Phillips	218791811	107100855	0.49	111690956	0.51	2013
724	The Prince of Egypt	218613188	101413188	0.464	117200000	0.536	1998
725	Jack Reacher	218340595	80070736	0.367	138269859	0.633	2012
726	Kingdom of Heaven	218122627	47398413	0.217	170724214	0.783	2005
727	The Emoji Movie	217776646	86089513	0.395	131687133	0.605	2017
728	Dirty Dancing	217688008	64577242	0.297	153110766	0.703	1987
729	Dracula Untold	217124280	56280355	0.259	160843925	0.741	2014
730	Central Intelligence	216972543	127440871	0.587	89531672	0.413	2016
731	Million Dollar Baby	216763646	100492203	0.464	116271443	0.536	2004
732	The Help	216639112	169708112	0.783	46931000	0.217	2011
733	Twins	216614388	111938388	0.517	104676000	0.483	1988
734	Valentine's Day	216485654	110485654	0.51	106000000	0.49	2010
735	Bad Teacher	216197492	100292856	0.464	115904636	0.536	2011
736	One Hundred and One Dalmatians	216026182	144880014	0.671	71146168	0.329	1961
737	Clear and Present Danger	215887717	122187717	0.566	93700000	0.434	1994
738	Ted 2	215863606	81476385	0.377	134387221	0.623	2015
739	Bram Stoker's Dracula	215862692	82522790	0.382	133339902	0.618	1992
740	Vertical Limit	215663859	69243859	0.321	146420000	0.679	2000
741	Ghostbusters II	215394738	112494738	0.522	102900000	0.478	1989
742	The Patriot	215294342	113330342	0.526	101964000	0.474	2000
743	The Sorcerer's Apprentice	215283742	63150991	0.293	152132751	0.707	2010
744	Just Go with It	214945591	103028109	0.479	111917482	0.521	2011
745	The Expendables 3	214657577	39322544	0.183	175335033	0.817	2014
746	Creed II	214215889	115715889	0.54	98500000	0.46	2018
747	Pulp Fiction	214179088	107928762	0.504	106250326	0.496	1994
748	Public Enemies	214104620	97104620	0.454	117000000	0.546	2009
749	Smallfoot	214040103	83240103	0.389	130800000	0.611	2018
750	The Bourne Identity	214034224	121661683	0.568	92372541	0.432	2002
751	Disclosure	214015089	83015089	0.388	131000000	0.612	1994
752	The Aviator	213719942	102610330	0.48	111109612	0.52	2004
753	Crouching Tiger, Hidden Dragon	213525736	128078872	0.6	85446864	0.4	2000
754	Braveheart	213216216	75609945	0.355	137606271	0.645	1995
755	Into the Woods	212902372	128002372	0.601	84900000	0.399	2014
756	Bedtime Stories	212874864	110101975	0.517	102772889	0.483	2008
757	Miss Congeniality	212742720	106807667	0.502	105935053	0.498	2000
758	Entrapment	212404396	87704396	0.413	124700000	0.587	1999
759	Ace Ventura: When Nature Calls	212385533	108385533	0.51	104000000	0.49	1995
760	End of Days	211989043	66889043	0.316	145100000	0.684	1999
761	Bridget Jones's Baby	211952420	24252420	0.114	187700000	0.886	2016
762	Battle Los Angeles	211819354	83552429	0.394	128266925	0.606	2011
763	Fury	211817906	85817906	0.405	126000000	0.595	2014
764	Australia	211787511	49554002	0.234	162233509	0.766	2008
765	Due Date	211780824	100539043	0.475	111241781	0.525	2010
766	Master and Commander: The Far Side of the World	211622535	93927920	0.444	117694615	0.556	2003
767	Lemony Snicket's A Series of Unfortunate Events	211468235	118634549	0.561	92833686	0.439	2004
768	District 9	210888950	115646235	0.548	95242715	0.452	2009
769	The Jungle Book	210310084	141843612	0.674	68466472	0.326	1967
770	Moonraker	210308099	70308099	0.334	140000000	0.666	1979
771	The Others	209947037	96522687	0.46	113424350	0.54	2001
772	Horrible Bosses	209838559	117538559	0.56	92300000	0.44	2011
773	Red Dragon	209196298	93149898	0.445	116046400	0.555	2002
774	Tomorrowland	209035668	93436322	0.447	115599346	0.553	2015
775	Me Before You	208314186	56245075	0.27	152069111	0.73	2016
776	Safe House	208076205	126373434	0.607	81702771	0.393	2012
777	S.W.A.T.	207725639	116934650	0.563	90790989	0.437	2003
778	Traffic	207515725	124115725	0.598	83400000	0.402	2000
779	The Fast and the Furious	207284863	144533925	0.697	62750938	0.303	2001
780	Paranormal Activity 3	207039844	104028807	0.502	103011037	0.498	2011
781	Philadelphia	206678440	77446440	0.375	129232000	0.625	1993
782	Sleepy Hollow	206071502	101071502	0.49	105000000	0.51	1999
783	Little Women	206006503	108101214	0.525	97905289	0.475	2019
784	The Holiday	205841885	63224849	0.307	142617036	0.693	2006
785	London Has Fallen	205754447	62524260	0.304	143230187	0.696	2016
786	A Dog's Purpose	205736628	64508620	0.314	141228008	0.686	2017
787	The Break-Up	205668210	118703275	0.577	86964935	0.423	2006
788	Journey to the West	205637183	18058		205619125	1	2013
789	JFK	205405498	70405498	0.343	135000000	0.657	1991
790	White House Down	205366737	73103784	0.356	132262953	0.644	2013
791	Fun with Dick and Jane	204681899	110332737	0.539	94349162	0.461	2005
792	Eat Pray Love	204594016	80574010	0.394	124020006	0.606	2010
793	You Don't Mess with the Zohan	204313400	100018837	0.49	104294563	0.51	2008
794	King Arthur	203567857	51882244	0.255	151685613	0.745	2004
795	Hairspray	203552922	118871849	0.584	84681073	0.416	2007
796	Yogi Bear	203518375	100246011	0.493	103272364	0.507	2010
797	Everest	203427584	43482270	0.214	159945314	0.786	2015
798	Vanilla Sky	203388341	100618344	0.495	102769997	0.505	2001
799	Arrival	203388186	100546139	0.494	102842047	0.506	2016
800	Need for Speed	203277636	43577636	0.214	159700000	0.786	2014
801	Ponyo	203204882	15743471	0.078	187461411	0.922	2008
802	Garfield	203172417	75369589	0.371	127802828	0.629	2004
803	The Addams Family	203044905	100044905	0.493	103000000	0.507	2019
804	Patch Adams	202292902	135026902	0.668	67266000	0.332	1998
805	Teenage Mutant Ninja Turtles	201965915	135265915	0.67	66700000	0.33	1990
806	Kindergarten Cop	201957688	91457688	0.453	110500000	0.547	1990
807	Birds of Prey: And the Fantabulous Emancipation of One Harley Quinn	201858461	84158461	0.417	117700000	0.583	2020
808	Straight Outta Compton	201634991	161197785	0.8	40437206	0.2	2015
809	21 Jump Street	201585328	138447667	0.687	63137661	0.313	2012
810	Valkyrie	201545517	83077833	0.412	118467684	0.588	2008
811	Open Season	200811689	85105259	0.424	115706430	0.576	2006
812	Cats & Dogs	200687492	93385515	0.465	107301977	0.535	2001
813	The Hunt for Red October	200512643	122012643	0.608	78500000	0.392	1990
814	Percy Jackson: Sea of Monsters	199850315	68559554	0.343	131290761	0.657	2013
815	Two Weeks Notice	199043242	93354851	0.469	105688391	0.531	2002
816	RED	199006387	90380162	0.454	108626225	0.546	2010
817	City of Angels	198685114	78685114	0.396	120000000	0.604	1998
818	The Pacifier	198636868	113086868	0.569	85550000	0.431	2005
819	50 First Dates	198520934	120908074	0.609	77612860	0.391	2004
820	Total Recall	198467168	58877969	0.297	139589199	0.703	2012
821	The Island	198326350	670883	0.003	197655467	0.997	2018
822	The Impossible	198087212	19019882	0.096	179067330	0.904	2012
823	Lost in Thailand	197757387	57387		197700000	1	2012
824	Christopher Robin	197744377	99215042	0.502	98529335	0.498	2018
825	Jack the Giant Slayer	197687603	65187603	0.33	132500000	0.67	2013
826	Smurfs: The Lost Village	197183546	45020282	0.228	152163264	0.772	2017
827	Spy Kids 3-D: Game Over	197101678	111761982	0.567	85339696	0.433	2003
828	Panic Room	197079546	96397334	0.489	100682212	0.511	2002
829	The Other Woman	196710396	83911193	0.427	112799203	0.573	2014
830	Stargate	196567262	71567262	0.364	125000000	0.636	1994
831	Beowulf	196393745	82280579	0.419	114113166	0.581	2007
832	The Vow	196114570	125014030	0.638	71100540	0.362	2012
833	Anger Management	195745823	135645823	0.693	60100000	0.307	2003
834	Tropic Thunder	195702811	110515313	0.565	85187498	0.435	2008
835	The Shape of Water	195333312	63859435	0.327	131473877	0.673	2017
836	The Pelican Brief	195268056	100768056	0.516	94500000	0.484	1993
837	The BFG	195243411	55483770	0.284	139759641	0.716	2016
838	Rocketman	195179299	96368160	0.494	98811139	0.506	2019
839	The Intern	194564672	75764672	0.389	118800000	0.611	2015
840	Wallace & Gromit: The Curse of the Were-Rabbit	194111171	56110897	0.289	138000274	0.711	2005
841	Gnomeo & Juliet	193967670	99967670	0.515	94000000	0.485	2011
842	The Sum of All Fears	193921372	118907036	0.613	75014336	0.387	2002
843	Gangs of New York	193772504	77812000	0.402	115960504	0.598	2002
844	The Monkey King 2	193678298	709982	0.004	192968316	0.996	2016
845	Paranormal Activity	193355800	107918810	0.558	85436990	0.442	2009
846	The Equalizer	192330738	101530738	0.528	90800000	0.472	2014
847	The Lego Movie 2: The Second Part	192306508	105806508	0.55	86500000	0.45	2019
848	Downton Abbey	192094429	96854135	0.504	95240294	0.496	2019
849	The Addams Family	191502426	113502426	0.593	78000000	0.407	1991
850	The Longest Yard	191466556	158119460	0.826	33347096	0.174	2005
851	Cheaper by the Dozen	190538630	138614544	0.728	51924086	0.272	2003
852	The Equalizer 2	190400157	102084362	0.536	88315795	0.464	2018
853	Hollow Man	190213455	73209340	0.385	117004115	0.615	2000
854	Abominable	189892513	60716390	0.32	129176123	0.68	2019
855	Outbreak	189859560	67659560	0.356	122200000	0.644	1995
856	The Santa Clause	189833357	144833357	0.763	45000000	0.237	1994
857	The White Storm 2: Drug Lords	189396380	609461	0.003	188786919	0.997	2019
858	The X Files	189176423	83898313	0.444	105278110	0.556	1998
859	Breakup Buddies	189017596	777896	0.004	188239700	0.996	2014
860	Rambo III	189015611	53715611	0.284	135300000	0.716	1988
861	The Secret Life of Walter Mitty	188133322	58236838	0.31	129896484	0.69	2013
862	Jaws 2	187884007	81766007	0.435	106118000	0.565	1978
863	12 Years a Slave	187733202	56671993	0.302	131061209	0.698	2013
864	Heat	187436818	67436818	0.36	120000000	0.64	1995
865	Mr. Popper's Penguins	187361754	68224452	0.364	119137302	0.636	2011
866	The Grudge	187281115	110359362	0.589	76921753	0.411	2004
867	I Now Pronounce You Chuck & Larry	187134117	120059556	0.642	67074561	0.358	2007
868	The Horse Whisperer	186883563	75383563	0.403	111500000	0.597	1998
869	Weathering with You	186829542	7798743	0.042	179030799	0.958	2019
870	Walk the Line	186797986	119519402	0.64	67278584	0.36	2005
871	The Jungle Book 2	186303759	47901582	0.257	138402177	0.743	2003
872	The Final Destination	186167139	66477700	0.357	119689439	0.643	2009
873	Atlantis: The Lost Empire	186053725	84056472	0.452	101997253	0.548	2001
874	Inside Man	186003591	88513495	0.476	97490096	0.524	2006
875	The Waterboy	185991646	161491646	0.868	24500000	0.132	1998
876	Hugo	185770160	73864507	0.398	111905653	0.602	2011
877	Pitch Perfect 3	185400345	104897530	0.566	80502815	0.434	2017
878	Watchmen	185382813	107509799	0.58	77873014	0.42	2009
879	The Birdcage	185260553	124060553	0.67	61200000	0.33	1996
880	Moulin Rouge!	184928135	57386607	0.31	127541528	0.69	2001
881	Snow White and the Seven Dwarfs	184925486	184925486	1	0	0	1937
882	Hop	183953723	108085305	0.588	75868418	0.412	2011
883	Bad Moms	183936074	113257297	0.616	70678777	0.384	2016
884	Jupiter Ascending	183887723	47387723	0.258	136500000	0.742	2015
885	Knowing	183658498	79957634	0.435	103700864	0.565	2007
886	102 Dalmatians	183611771	66957026	0.365	116654745	0.635	2000
887	Storks	183388953	72679278	0.396	110709675	0.604	2016
888	Paul Blart: Mall Cop	183348429	146336178	0.798	37012251	0.202	2009
889	Wayne's World	183097323	121697323	0.665	61400000	0.335	1992
890	Maverick	183031272	101631272	0.555	81400000	0.445	1994
891	Mirror Mirror	183018522	64935167	0.355	118083355	0.645	2012
892	The Man in the Iron Mask	182968902	56968902	0.311	126000000	0.689	1998
893	Cape Fear	182291969	79091969	0.434	103200000	0.566	1991
894	The Haunted Mansion	182290266	75847266	0.416	106443000	0.584	2003
895	While You Were Sleeping	182057016	81057016	0.445	101000000	0.555	1995
896	The Bridges of Madison County	182016617	71516617	0.393	110500000	0.607	1995
897	Poseidon	181674817	60674817	0.334	121000000	0.666	2006
898	The First Wives Club	181489203	105489203	0.581	76000000	0.419	1996
899	Scooby-Doo 2: Monsters Unleashed	181216833	84216833	0.465	97000000	0.535	2004
900	Hot Shots!	181096164	69467617	0.384	111628547	0.616	1991
901	Road to Perdition	181001478	104454762	0.577	76546716	0.423	2002
902	Kill Bill: Vol. 1	180899045	70099045	0.388	110800000	0.612	2003
903	The Hitman's Bodyguard	180650747	75468583	0.418	105182164	0.582	2017
904	The Scorpion King	180630907	91047077	0.504	89583830	0.496	2002
905	Sweet Home Alabama	180622424	127223418	0.704	53399006	0.296	2002
906	Daddy's Home 2	180613180	104029443	0.576	76583737	0.424	2017
907	Deja Vu	180557550	64038616	0.355	116518934	0.645	2006
908	Hacksaw Ridge	180450918	67209615	0.372	113241303	0.628	2016
909	The Post	179769457	81903458	0.456	97865999	0.544	2017
910	Dangerous Minds	179519401	84919401	0.473	94600000	0.527	1995
911	The Dictator	179379533	59650222	0.332	119729311	0.668	2012
912	The League of Extraordinary Gentlemen	179265204	66465204	0.371	112800000	0.629	2003
913	Allegiant	179246868	66184051	0.369	113062817	0.631	2016
914	Daredevil	179179718	102543518	0.572	76636200	0.428	2003
915	City Slickers	179033791	124033791	0.693	55000000	0.307	1991
916	He's Just Not That Into You	178866158	93953653	0.525	84912505	0.475	2009
917	Eagle Eye	178767383	101440743	0.567	77326640	0.433	2008
918	Along Came Polly	178311729	88097164	0.494	90214565	0.506	2004
919	Flushed Away	178281554	64665672	0.363	113615882	0.637	2006
920	Scary Movie 4	178262620	90710620	0.509	87552000	0.491	2006
921	Dante's Peak	178127760	67127760	0.377	111000000	0.623	1997
922	Brokeback Mountain	178062759	83043761	0.466	95018998	0.534	2005
923	Patriot Games	178051587	83351587	0.468	94700000	0.532	1992
924	Flubber	177977226	92977226	0.522	85000000	0.478	1997
925	Baywatch	177856751	58060186	0.326	119796565	0.674	2017
926	Double Jeopardy	177841558	116741558	0.656	61100000	0.344	1999
927	War Horse	177584879	79884879	0.45	97700000	0.55	2011
928	Paranormal Activity 2	177512032	84752907	0.477	92759125	0.523	2010
929	How to Lose a Guy in 10 Days	177502387	105813373	0.596	71689014	0.404	2003
930	Alien vs. Predator	177427090	80282231	0.452	97144859	0.548	2004
931	Hero	177395557	53710019	0.303	123685538	0.697	2002
932	The 40-Year-Old Virgin	177378645	109449237	0.617	67929408	0.383	2005
933	Lee Daniels' The Butler	177313795	116632095	0.658	60681700	0.342	2013
934	The Haunting	177311151	91411151	0.516	85900000	0.484	1999
935	The Descendants	177243185	82584160	0.466	94659025	0.534	2011
936	The A-Team	177238796	77222099	0.436	100016697	0.564	2010
937	Tootsie	177200000	177200000	1	0	0	1982
938	In the Line of Fire	176997168	102314823	0.578	74682345	0.422	1993
939	Analyze This	176885658	106885658	0.604	70000000	0.396	1999
940	Looper	176506819	66486205	0.377	110020614	0.623	2012
941	Dr. Dolittle 2	176104344	112952899	0.641	63151445	0.359	2001
942	The Italian Job	176070171	106128601	0.603	69941570	0.397	2003
943	The Bucket List	175372502	93466502	0.533	81906000	0.467	2007
944	Sleeping with the Enemy	174999005	101599005	0.581	73400000	0.419	1991
945	Cowboys & Aliens	174822325	100240551	0.573	74581774	0.427	2011
946	The Mule	174804407	103804407	0.594	71000000	0.406	2018
947	George of the Jungle	174463257	105263257	0.603	69200000	0.397	1997
948	Evan Almighty	174440724	100462298	0.576	73978426	0.424	2007
949	Identity Thief	173965010	134506920	0.773	39458090	0.227	2013
950	The Nutcracker and the Four Realms	173961069	54858851	0.315	119102218	0.685	2018
951	Big Momma's House	173959438	117559438	0.676	56400000	0.324	2000
952	In Time	173930596	37520095	0.216	136410501	0.784	2011
953	Amélie	173924742	33225499	0.191	140699243	0.809	2001
954	Operation Mekong	173839072	800012	0.005	173039060	0.995	2016
955	Anchorman 2: The Legend Continues	173649931	127352707	0.733	46297224	0.267	2013
956	Creed	173567581	109767581	0.632	63800000	0.368	2015
957	Gemini Man	173469516	48546770	0.28	124922746	0.72	2019
958	The Girl on the Train	173185859	75395035	0.435	97790824	0.565	2016
959	Scream	173046663	103046663	0.596	70000000	0.404	1996
960	Cold Mountain	173013509	95636509	0.553	77377000	0.447	2003
961	Black Hawk Down	172989651	108638745	0.628	64350906	0.372	2001
962	The Grand Budapest Hotel	172936941	59301324	0.343	113635617	0.657	2014
963	The Santa Clause 2	172855065	139236327	0.806	33618738	0.194	2002
964	Cloverfield	172394180	80048433	0.464	92345747	0.536	2008
965	Scream 2	172363301	101363301	0.588	71000000	0.412	1997
966	Couples Retreat	171844840	109204945	0.636	62639895	0.364	2009
967	Antz	171757863	90757863	0.528	81000000	0.472	1998
968	Blood Diamond	171720398	57377916	0.334	114342482	0.666	2006
969	Jackass 3D	171685792	117229692	0.683	54456100	0.317	2010
970	No Country for Old Men	171627166	74283625	0.433	97343541	0.567	2007
971	Spies in Disguise	171616764	66757013	0.389	104859751	0.611	2019
972	John Wick: Chapter 2	171539887	92029184	0.536	79510703	0.464	2017
973	Cocktail	171504781	78222753	0.456	93282028	0.544	1988
974	Mr. Deeds	171269535	126293452	0.737	44976083	0.263	2002
975	Contact	171120329	100920329	0.59	70200000	0.41	1997
976	Superbad	170812526	121463226	0.711	49349300	0.289	2007
977	The Other Guys	170458922	119219978	0.699	51238944	0.301	2010
978	The Specialist	170362582	57362582	0.337	113000000	0.663	1994
979	Olympus Has Fallen	170270201	98925640	0.581	71344561	0.419	2013
980	Starsky & Hutch	170268750	88237754	0.518	82030996	0.482	2004
981	Shall We Dance	170128460	57890460	0.34	112238000	0.66	2004
982	Stuart Little 2	169956806	64956806	0.382	105000000	0.618	2002
983	Zookeeper	169852759	80360843	0.473	89491916	0.527	2011
984	Dumb and Dumber To	169837010	86208010	0.508	83629000	0.492	2014
985	Ghost in the Shell	169801921	40563557	0.239	129238364	0.761	2017
986	Seven Pounds	169748929	69951824	0.412	99797105	0.588	2008
987	Meet the Robinsons	169333034	97822171	0.578	71510863	0.422	2007
988	The Emperor's New Groove	169327687	89302687	0.527	80025000	0.473	2000
989	12 Monkeys	168839459	57141459	0.338	111698000	0.662	1995
990	Dodgeball	168423227	114326736	0.679	54096491	0.321	2004
991	Hellboy II: The Golden Army	168319243	75986503	0.451	92332740	0.549	2008
992	Insidious: The Last Key	167885588	67745330	0.404	100140258	0.596	2018
993	Fantastic Four	167882881	56117548	0.334	111765333	0.666	2015
994	Unstoppable	167805466	81562942	0.486	86242524	0.514	2010
995	Three Men and a Baby	167780960	167780960	1	0	0	1987
996	Magic Mike	167739368	113721571	0.678	54017797	0.322	2012
997	Alexander	167298192	34297191	0.205	133001001	0.795	2004
998	Up in the Air	166842739	83823381	0.502	83019358	0.498	2009
999	Nutty Professor II: The Klumps	166339890	123309890	0.741	43030000	0.259	2000
1000	Sleepers	165615285	53315285	0.322	112300000	0.678	1996